#################################
#...#...#..........#####.....####
#...##......####....###.........#
#.......##....#...###...........#
####.......####.............#####
#........###........##..........#
#........####.....###...........#
#####....#........###........####
#...#....#..#######...###########
#...#....#..#...#...###......####
#...######..#.....#...###....####
#...............................#
####..#######..##...##.......####
#.............#....##....########
#################################