####################
#..................#
#..##.....##.......#
#..................#
#....######........#
#..................#
#.....###..#....####
###.......####.....#
####################
