#################################
#....##...#.......#####......####
#...##.......####.....###.......#
#........##.....#...###.........#
####.........####...........#####
#..........###.........##.......#
#...........####......###.......#
#####.......#.........###....####
#...#....#..#######...###########
#...#....#..#.....#...###....####
#...######..#.....#...###....####
#...........#...................#
#############..##...##.......####
#..............#....##...########
#################################