########################################
#.......................#..............#
#..######...######......#......######..#
#..#....#...#....#.............#....#..#
#..#....#...#....#######...######....#.#
#..#.................................#.#
#..######...#########...######...######.#
#.........#...........#........#.......#
#..######.#.#######.#.#######.#.#####..#
#..#....#.#.#.....#.#.#.....#.#.#.....#
#..#....#.#.#.....#.#.#.....#.#.#.....#
#..#....#.#.#######.#.#######.#.#####.#
#..#..................................#
#..#########...###########...#########.#
#..............#.........#............#
#..######......#.........#......######.#
#..#....#.........................#...#
#..#....#...###############...#..#....#
#..#....#..................#...#..#....#
#..######..................#.....#.....#
#......................#...............#
#..#...................................#
########################################